11111111111111111111111111111111111
100000101111000001C0111110111110111
1P00110101010100100110010E100101001
10101010100101010010010CC0101001011
1100010000001C000C01010010101010011
100000011000000C000000C011010100111
1111010100101001001C101001010101001
11111111111111111111111111111111111
