11111111111111111111111
1E10C00000C000000000001
10100101001000000010101
10000101010100010000101
101P00C00C00000000000C1
11111111111111111111111
